+--+--+--+--+--+--+--+
|@       |        |  |
+--+--+  +  +--+  +  +
|>    |  |     |     |
+--+  + *+  +  +--+  +
|     |* |  |  |     |
+  +--+ *+  +  +  +--+
|     |* |  |  |     |
+  +--+  +  +  +--+  +
|  |     |  |  |  |  |
+  +  +--+  +  +  +  +
|        *  |  |    *|
+--+  +--+--+--+--+  +
|     |X             |
+--+--+--+--+--+--+--+
