+--+--+--+--+--+--+--+--+--+--+--+--+--+--+--+
|@ |           |        |        |     |     |
+  +  +--+--+  +  +--+--+  +--+  +--+  +  +  +
|     |     |        |     |     |     |  |  |
+--+--+  +  +--+--+  +  +--+  +--+  +--+* +  +
|        |  |  *     |  |  |     |  |  *  |  |
+  + *+--+  +  +--+--+  +  +--+  +  +  +--+  +
|  |     |     |        |  |  |  |  |  *  |  |
+  +--+  +--+--+  +  +--+  +  +  +  +--+  +  +
|     |  |        |     |  |  |     |  *  |  |
+--+  +  +  +--+--+  +  +  +  +--+--+  +--+  +
|     |  |  |     |  |  *     |  *  |     | >|
+--+--+  +  +  +  +  +  +  +--+ *+* +--+  +--+
|        |  |  |     |  |  |     |     |     |
+  +--+--+  +  +--+--+  +--+  +--+--+  +--+  +
|     *  |  |        |     |     |  |  *  |  |
+--+--+  +  +--+--+  +--+  +--+  +  +--+  +  +
|     |  |  |     |  |           |     |     |
+--+  +  +  +  +--+  +  +--+--+  +--+  +--+  +
|     |  *  |        |   *    |  *  |        |
+  +**+--+--+--+--+--+--+--+  +--+* +--+--+--+
|  |  |        |     |        | X|     |     |
+  +  +  +  +--+  +--+  +--+--+  +--+* +  +  +
|  |     |  *  |        |        |     |  |  |
+  +--+--+--+  +--+  +--+* +--+--+--+  +  +  +
|  |        |        |  *  |     |     |  |  |
+  +  +--+  +--+  +--+  +--+  +  +  +--+  +  +
|  |  |     |  |  |  |  |     |  |     *  |  |
+  +--+  +--+  +  +  +  +  +--+--+--+--+--+  +
|        |           |    *                  |
+--+--+--+--+--+--+--+--+--+--+--+--+--+--+--+
