+--+--+--+--+--+--+--+--+
|@       |     |        |
+--+--+  +  +  +  +--+  +
|  |   * |  | **  |  *  |
+  +  + *+  +  +--+  +--+
|     | *|  |  |     |  |
+--+--+  +  +  +  +--+  +
|  |      * |  |  |     |
+  +  +--+--+  +  +  +--+
|  |  |        |       >|
+  +  +  +**+--+--+--+--+
|     |  | *|     |     |
+--+--+  +  +  + *+  +  +
|     |  |  | X|  *  |  |
+  +  +  +  +--+--+--+  +
|  |     |              |
+--+--+--+--+--+--+--+--+
