+--+--+--+--+--+
|  *    @|     |
+  +--+--+  +  +
|  *        |  |
+--+--+--+--+  +
|     |>     * |
+  +  +--+--+  +
|  |           |
+  +--+--+--+--+
|             X|
+--+--+--+--+--+
