+--+--+--+--+--+--+--+--+--+--+
|@       |     |     |       >|
+  +--+  +--+  +  +  +  +--+--+
|  |  |        |  |  |        |
+  +  +--+--+--+  +--+--+--+  +
|  |     |     |        *     |
+  +--+  +  +  +--+--+* +--+--+
|  |  |  |  |  |     *  |     |
+  +  +  +--+**+  +--+--+  +  +
|  |     |  *     |     *  |  |
+  +  +--+  +**+--+--+* +--+  +
|**   |     |  |     | *|   * |
+  +--+  +--+  +  +  +  +--+ *+
|*       |  |  |  |  |     | *|
+--+--+--+  +  +--+  +--+  +  +
|              |  *  *  |  |  |
+  +--+--+--+--+  +* +  +  +  +
|  |  *     |     |  |  |  |  |
+  +  +--+  +  +--+  +--+  +  +
|     |        |           | X|
+--+--+--+--+--+--+--+--+--+--+
